NO ./textures/wolf_red.xpm
SO ./textures/wolf.xpm
WE ./textures/Greycross.xpm
EA ./textures/gray_red.xpm

C 155,100,100
F 110,144,154

        1111111111111111111111111                        1111111111111111111111111                      
        1000000000110000000000001                        1000000000110000000000001
        1011000001110000000000001                        1011000001110000000000001
        1001000000000000000000001                        1001000000000000000000001
111111111011000001110000000000001                111111111011000001110000000000001
100000000011000001110111111111111                100000000011000001110111111111111                
11110111111111011100000010001                    11110111111111011100000010001
11110111111111011101010010001                    11110111111111011101010010001
11000000110101011100000010001                    11000000110101011100000010001
10000000000000011000000100001                    11111111111111111111111111111
1000000N000000000001010010001
110000011101010111110111100101
11110111 1110101 101111010001
11111111 11111111111111111111111111111111111