NO ./textures/wolf_red.xpm
SO ./textures/superw.xpm
WE ./textures/brick_cu.xpm
EA ./textures/police.xpm

F 115,14,4

C 0,0,0

11111111111111111111111   
100000000000000000000001   
 1000000000000000000001
  10000000000000000001   
   100000000000000001   
    1000000000000001  
     10000000000001   
      100000000001
       1000000001   
        10000001   
         100101   
          11N1
           11