NO ./textures/wolf_red.xpm
SO ./textures/wolf.xpm
WE ./textures/Multibrick.xpm
EA ./textures/gray_red.xpm
C 155,100,160
F 111,111,255

111N11111111111111
11111111000000001
10100000100000101
10000000000000001
10001000100010001
10000000000000001
10101010010101011
10000000000000001
10001000100100001
10000000000000001
10100000100001111
10000000000001101
11111111111111111