NO ./textures/wolf_red.xpm
SO ./textures/wolf.xpm
WE ./textures/Multibrick.xpm
EA ./textures/gray_red.xpm

F 1,1,1
C 110,99,70

    111111111111111111111111111
 11100000011000000000000001
   11100111000000000000001
 111100000000000000000E00111
    1111111110110000011100011
  1100000000000000111011111111
  11110000000001011100000010011
1111000000000101010101000000001111111
    1110000001111111111111110000111111
 111111100000001           110000000001                      111
 10001000100100011           100000000001                      111
10000000000000001           100000000001                      10111111111111111111111111111111111111111111111111111111111111111111111111111111111111111111111111111111
1010000010000100111111111111100010010001111111111111111111111110110000000000000000000000000000000000000000000000000000000000000000000000000000000000000000000000000001
10000000000000000000000000000000000000000000000000000000000000000000000000000000000000000000000000000000000000000000000000000000000000000000000000000000000000000000001
11110011111111111111111111111000100100011111111111111111111111101111111111111111111111111111111111111111111111111111111111111111111111111111111111111111111111111111111
  111001                     11111111111                      111
  111000111111111111111111
 10000000000000001111111111
110000000001010111110111101
11110000000010110111101001
111111111111111111111111111